1111111111111
10010000001C1
1000011111101
1P0011E000101
1111111111111
